222222222222222222222
200000000000000000002
201010101010101010102
200000000000000000002
201010101010101010102
200000000000000000002
201010101010101010102
200000000000000000002
201010101010101010102
200000000000000000002
201010101010101010102
200000000000000000002
201010101010101010102
200000000000000000002
201010101010101010102
200000000000000000002
201010101010101010102
200000000000000000002
201010101010101010102
200000000000000000002
222222222222222222222
