2222222222222222222
2001110001000111002
2021202021202021202
2111001011101001112
2120202020202020212
2110011100011100112
2121212120212121212
2010011111111100102
2121212120212121212
2010011100011100112
2020202020202020212
2111001011101001112
2021202021202021202
2001110001000111002
2222222222222222222
