222222222222222222222
210101011111111111112
200000002002111111112
210101012002111111112
200000002002111111112
210101012002111111112
200000002002111111112
210101012002111111112
212222222002222222212
210000000000000000012
210000000000000000012
212222222002222222212
201010102002111111112
201010102002000000002
201010102002111111112
201010102002000000002
201010102002111111112
201010102002000000002
201010101111111111112
222222222222222222222
